20 20
100 100
2 2 2 2 2 2 2 2 2 2 2 2 2 2 2 2 2 2 2 2
2 1 4 1 1 1 1 1 1 1 1 1 1 1 1 1 1 1 1 2
2 1 4 2 2 2 2 1 1 1 0 0 0 3 0 0 0 0 1 2
2 1 4 0 0 0 0 0 0 0 0 0 0 4 0 0 0 0 1 2
2 1 4 0 0 1 1 1 1 1 0 0 0 4 0 0 0 0 1 2
2 1 4 0 2 2 2 2 1 0 0 0 0 4 0 0 0 0 1 2
2 1 4 0 0 0 0 0 0 0 0 0 0 4 0 0 0 0 1 2
2 1 4 4 2 2 2 2 1 2 0 0 0 4 0 0 0 0 1 2
2 1 0 4 4 3 0 2 0 2 0 0 0 4 0 0 0 0 1 2
2 1 0 0 4 4 4 2 1 2 0 0 0 4 0 0 0 0 1 2
2 1 0 0 0 4 4 2 0 2 0 0 0 4 0 0 0 0 1 2
2 1 0 0 0 0 4 4 4 4 4 4 4 4 4 4 4 4 1 2
2 1 0 0 0 0 0 0 0 4 3 4 0 0 0 0 0 0 1 2
2 1 0 0 0 0 0 0 0 4 4 4 0 0 0 0 0 0 1 2
2 1 0 0 0 0 0 0 0 0 4 0 0 0 0 0 0 0 1 2
2 1 0 0 0 0 0 0 0 1 1 1 0 0 0 0 0 0 1 2
2 1 0 0 0 0 0 0 0 1 3 1 0 0 0 0 0 0 1 2
2 1 0 0 0 0 0 0 0 1 1 1 0 0 0 0 0 0 1 2
2 1 0 0 0 0 0 0 0 0 0 0 0 0 0 0 0 0 1 2
2 2 2 2 2 2 2 2 2 2 2 2 2 2 2 2 2 2 2 2